12111
10101
10101
10001
11011
11003
